1111111111111
10010000000C1
1000011E11001
1P00111110001
1111111111111