1111111111111
100100E0P00C1
1000011011001
1111111111111